                         X                 X              SX
               X      X                    X             XXX
XXXXXXXXXXXXXXXX             XXXXXXXX              XXXX     
                      X                                     
                      X                                     
   X                  X                                    X
   X         XXXXXXXXX  XXXXXXXXXXXXXX   XXXXXXXXXXXXXX    X
XX X     XXXXX          XXXXXXXXXXXXXX                     X
G  XXXXXXX              XXXXXXXXXXXXXX                     X
XX   X                              X                       
     X                         XXXXXXXXXXXXXX               
    XXXXXXXXXXXXXXXXX                                       
                                                            